000000000000000000000000303000003000000000000000
000000000000000000000003333330330000000000000000
000000000000000000000033111133300030000000000000
000000000000000000000033111111303030000000000000
000000000000000000030303111111333333000000000000
000000000000000000333003111141111223000000000000
000000000000000000033333111141442223300000000000
000000000000000000331111111111141221300000000000
000000000000000003311111111111141223300000000000
000000000000000003111111111111111113003003000000
000000000000033303114444111111333333030033000000
000000000000031333111111111111333333000333000000
000000000000033111111111111333330003030033000000
000000000000303111111111133333030003333333000000
000000000000033111411111130000000003111303000000
000000000030331111414113330000000003311300000000
000030003003333111414113030000000000333300000000
000033333333003111114333300000000003330000000000
000003123033033331133333300000000033300000000000
000003333303030333330000000000000003300000000000
000000333303000333000000000000000000000000000000
000000003300000000000000000000000000000000000000
000000000000000000000000000000000000000000000000
000000000000000000000000000000000000000000000000
000000000000000000000000000000000000000000000000
000000000000000000000000000000000000000000000000
030000000000000000000000000000000000000000000000
003303033303000000000000000000000000000000000000
333333333330000000000000000000000000000000000000
030303030330000000000000000000000000000003000000
000000000000000330000000000000000000000000330000
000000000000003300000333030000000300000003330000
000000000000033300000033033330033000000000000000
000000000000333000000033331333033000000000000000
000000000000330000000033111130333300000000000000
000000000000000000000031111133311330000000000000
000000000000000000000333111333311330000000000000
000000000000000000000003133300311300000000000000
000000000000000000000003330300311330000000000000
000000000000000000000033333333311300000000000000
000000000000000000000331113333333330000000000000
000000000000000000333333333003003300000000000000
000000000003030003300003003333033000000000000000
000000000000330003330000030333030000000000000000
000000000003300030033303000030333000000000000000
000000000003033333330333000030330000000000000000
000000000030333332133333000033303000000000000000
000000000000333032241130000334330000000000000000
000000000000000333333333030311133300000000000000
000000330030000330303333003314133000000000000000
000000333300000000000000003331130000000000000000
000000313330003000030000000033333300000000000000
000003313333000033300000000033033000000000000000
003303113003303331300300000303000000000000000000
003333113333333111333003030303300000000300333000
330311141411111111133033300333300000000033330000
030311141411444411130031333330333000300031330000
003333311111411111133333330300303030303331330000
000030331111411111113333030330330330333111300000
000000331111411111133033333030303330331333300000
000000033333411111330003300033303000033333300000
000000000303411111300030300030333000003303330000
000000000033333441300333003033030000030330300000
000000000000003333303330000003000003333003303000
000000000000030030303330333030000000003000033000
000000000000000000003300313300000000003330333000
000000000000000000000333311330000000000333000000
000000000000000030000031111300000033330313300000
000000000000000330000331111333000003333311330000
000000000000003303300033133333333303331111330000
000000000000000003333003130333333003032111300000
000333303000000003333003333300330000032113300000
003311303030303003300300330000000000331113030000
003111333333333333003033033000000000031113300000
033111111141144113300333000000000003333113333000
033334111141133313300033000000000000003333303330
000334111141330333000330300000000000000033033330
000034111141303333030300000000000000000000030300
033331111111330303303303330000000000000003303300
033333331114300333333000033000000000000033300000
000330031114333330300000030000000000000030030000
300330333333333330000000033000000000000003333000
303333300300033330000000000300000000000003330000
333333000000000000000000003333000003000300330000
033033300300000000000000333113330333333300300000
000003333000000000000000003141133311111333333000
000003300000000000000000033141114111141303330000
000000000000000000000003331144114111441333330000
000000000000000000000000331111111111111113030000
000000000000003300000000311111111111111113330000
000003000003000300000000311111111111111111130000
000330000033300000000000311111111111111111133000
000330000033300000000000311111111111111111330000
000000000033300000000000333333311111111111300000
000000000000000000000000030303333333333333300000
000000000000000000000000000000330303333330000000
