000000000000000000000000000000000000000000000000
000000000003000000333003000000000000000000000000
000000000033330300033330000000000000000000000000
000000003031433330303330000000000000000000000000
000000000331111133330300000000000000000000000000
000000003031444411333000000000000000000030000000
000000003331111111300000000000000000000033300000
000000000031122443300000000000000000000303300000
000000000031122133000000000000000000000003300000
000000000331111330000000000000000000000003033300
000000003333331303000030333330000003003033003300
000000003030031300330333031303000003033003000300
000000000003331333303303033333333333330303033000
000000000000033300300333003233033331133333330000
000000000000033000333030033223000311111111133000
000000000000033000333333303333303311111111130000
000000000000000000331300033003330333111111130330
000000000000000000031333303300003003411111133300
000000000000000003331111333000000303411111113300
000000000000000003111111333300000033111111113000
000000000000000033111143300333003003444444443300
000000000000000331441143003313333033111111113000
000000000000000034141143000311430034114444113300
000000000000000334141113333311433334111111133300
000000000000303314141111122441411111111111130000
000000000000033122111112222111411111141111330000
000000000000003333214112222221411111141111300000
000000000000003003211122222221411114141111330000
000000000000000003144422222211111114111111130300
000000000000000033111111111221111114111111133000
000000000000003331141111111111111114111411130300
000000000000003312241141111111111111111411133000
000000000000003332241141111111111111111433333000
003000000000000031141111111144111111333333300000
330000000000003331111444111111111333303000000000
330000000000003311111111111113333303333000000000
000000000003033111111111111113003303030000000000
000000030000303311333331111143000333300000000000
000003030303003133300033334113300033000000000000
000000303330003330000303033111330333300000000000
000000033330003000000303003111133313030000000000
000000000330000000000333303411111113300000000000
000000000000000000003303333111111113000000000000
000000000000000000000033111111141113003000000000
000000000000000003033031111111141113330000000000
000000000000000033030031133333141111330000000000
033333000000003033333331330303111111333000000000
003113000000003303331111300033111114133000000000
003333330300000000033333303003111114130000000000
030033333300000000030003333033111114133000000000
000000333300000000033003113331111114130000000000
000000330000000000033333111111133331133000000000
000000000000000000031111141411130031113003300000
000000000000000003331144411411130331113333300000
000000000000000003111111111111133311111111330000
000000000000030333111111111111111111144444330000
000000000003333311111111111111111111411111300000
000000000000314411111141221111111111111133300000
000000000333311114444111221111111111111133000000
000000000311111111111111111111114111111330000000
000000033311111111111111333331114111113300000000
000000033333331113333333333033311111333000000000
000000000003033333003030000000333333333000000000
003000000030333030030000000000003030000000000000
003300000033333300330000000000000000000000000000
003300000000330300333000003000000000000000000000
033330000000330333313303303030000000000000000000
003330000000000033112333330330000000000000000000
003300000000000003112211133333000000000000000000
000000000000000333111111111133300000000000000000
000000000000000311111111111113000000000000000000
000000000000000331122111133333000000000000000000
000000000000000033332113330300000000000000000000
000000000000000033333333000000000000000000000000
000000000000000000000300000000000000000000000000
