000000000000330000000000000000033300000000000000
000000000003300000000000000000033000000000000000
000000000003333030330000000000000000000000000000
000000000003123333330000000000000000000000000000
000000000033222211300000000000000000000000000000
000000000003222222330000000000000000000000000000
000000000033222222303000000000000000000000000000
000000000031221211330000000000000000000000000000
000000000331111411300000000000000000000000000000
000000003031111411303000000000000000000000000000
000000000331111411333030000030000000000000000000
000000000031111111113333303333300330000000000000
000000000033111111111111333111333030000000000000
003000000033114111111111222211113333300000000000
003033030034441144111111222211111111300000000000
000333300033111411111111422221111141330030000000
000033033003111411111111422221141441133330000000
000000033333111111111111112211141411113330000000
000003003111111111111111122221111111133000000000
000030333111111111111111112211444111130000000000
000303311111111111111113333211111111333000000000
000333111141111111111113003111144111300000000000
000031111141114441133333003333311111303000000000
003331114411111113330300000030333333333000000000
330331111111111333000000000000003033300300000000
300311111113333300000000000000000000333000000000
000311111113303300000000000000000000003330000000
003333111133000000000000000000000000003300000000
003031111130000000000000000000000000000000000000
000031111433000000000000000000000000000000000000
000033331433000000000000000000000000000000000000
000000033330000000000000000000000000000000000000
000000003300000000000000000000000000000000000000
000000333300000000000000003000000000000000000000
000000030300000000000000033300000000000000000000
000000000000000000000000003300000033330000000000
000000000000000000000000000000000003300000000000
000000000000000000000003300000000033300000000000
000000000030300000000333300000000000000000000000
000000303333330000000323000000000000000000000000
000000333111233033333323300000000030000000000000
000000033111113303111233300000003330000000000000
000000303111111333111230000000003300000000000000
000000033111444111111130000000003300000000000000
000000031111111111111133300000000000000000000000
000033331111141111111133000000000000000000000000
000303111111141114111133000000000000000000000000
000333111141114414114443000000000000000000000000
000031111141111114111113300000000000000000000000
000331212211111111141333300000000000000000000000
000032222111144433333303000000000000000000000000
000333332111141433303333000000000000000000000000
000003033333141333000300000000000000000000000000
000000000333333300000000000000303000000000000000
000000000000030000000000000000333000000000000000
000000000000000000000000000003333000000000000000
000000000000000000000000000333033000300000000000
000000000000000000000000000000000000330000000000
000000000000000000000000000000000000300000000000
333000000000000000000000000000000000000000000000
330000000000000000000000000000000000000000000000
000003300000000000000000000000000000000000000000
000333333330000000000000000000000000000000000000
000330030303000003030000000000000000330333303300
000300000330333033303030000000000000333311333300
003333000000333333333300000000000003330333113300
033133000000003330303300000000000000000003133000
033330000000000000000000000000000000000033330030
000030000000000000000000000000333300000333333330
000000000000000000000000000000033333333000333300
000000000000000000000000000000003333003300000030
000000030000030000000000000000033300003300000000
000000303333300000000000000000000000000000000000
000000333221300000000000000000000000000000000000
000033313333330000000000000000000000000000000000
000003333003300000000000000000003333000000000000
000033303300000000000000000000003303000000000000
000000333300000000000000000000000033300000000000
000000030000003300000000000000030303300000000000
000000000000033300000000000000033303000000000000
000000000000331330000000000000030303330000000000
000000000000331303000000000000330030300000000000
000000000300031330000000000000000033300000000000
000003033300331300000000000000000000000000000000
000333333000311330000000000000000000000000000000
000030003000333300000000000000000000000000000000
000000000000003300000000000000000000000000000000
000000000000000000000000000000000000000000000000
000000030000000000000000000000000000000000000000
000000000000000000000000000000000000000000000000
000000000000000000000000000000000000000000000000
000000000003333000000000000030000000000000000000
000000000003033030000000000003300000000000000000
000000000333333333033330000003300000000000000000
000000000033330030003330000000000000000000000000
000000000000000000003000000000000000000000000000
