000000000000000000000000000000000000000000000
000000000000000333300000000000000000000000000
000000000000000333000000000000000000000000000
000000000000000000000000000000000000000000000
003000000000000000000000003000000000000000000
003300000000000000000003033000000000000000000
033000000000000000000030333300000000000000000
333000000000000000000003033333000300000000000
000000000000000000000000031113330300000000000
000000000000000000000000333144133030000000000
000000000000000033000030003111143330000000000
000000000000000330330333303111141330000000000
000000000000000333303344333111111330000000000
000000000000333323333311111133311333000000000
000000000000031133033333333330333330000000000
000000000000033133030333033030333300000000000
000000000333303230330000003333003300000000000
000000003333303333330000000000000000000000000
000000033330000003300000000000330000000000000
000000030300000033300000000000030000000000000
000000000000000000000000000000000000000000000
000000000000000000000000000000000000000000000
000000000000000000000000000000000000000000000
000000000000000000000000000000000000000000000
000000000000000030000000000000000000000000000
000000000000000033000000000000000000300000000
000000000000000033330000000000003033000000000
000000000000033333330000000000000300003000000
000000000000003113000000000000033300333000000
000000000000033113000000000000003303030000000
000000000000031113300000000000000330330000000
000000000000333113000000000000000003330000000
000000000000003113030000000000000000330000000
000000000000003313330000000000000000000000000
000000000000000313330000000000000000000000000
000000000000000333000000000000000000000000000
000000000000000033300000000000000000003030030
000000000000003333300000000000000000000333330
000000000000000033000000000000000000003313300
000000000000000333000000000000300000003313000
000000000000000000000303303333300000003113000
000000000000000000003333300333300000003333300
003000000000000000000333303333000000033333300
000330000000000000000003033330000000000000000
030330000000000000000033003300000000000000000
003333000000000000000000003300000000000000000
000333000000000000000300000000000030000000000
000330000000000000000033300000303033000003300
000000000000000000003300030003030330000033300
000000000000000000000000000000333330000033300
000000000000000000000000000000033000000000000
000000000000000000003330330000330000000000000
000000000000000033033300300000333000000000000
000000000300003333331333030003300000000000000
000000030303333311112223300000000000000000000
000000033333111111112213300000000000000000000
000000331111111111141333300000000000000000000
000000331111113333333303300000000000000000000
000000333333333003030000000000000000000000000
000000033003333000000000000000000000000000000
000000000000000000000000000000000000000000000
000000000000000000000000000000000000000000000
000000000000000000000000000000000000000000000
000000000000000000000030000333000303300000000
000000000000000000030300000033030333333000000
000000000000000000033333000033333311113333000
000000000000000000003113003331111411113330000
000000000000000000033113333111111411113000000
000000000000000000331111111111111411113000000
000000000000000003331111111111111414443300000
000000000000000000031111111111111412213000000
000000000000000000033311111111111222213300000
000000000000000000000333111111111222221300000
000000000000000000000003111111112222211330000
000000000000000000000003333333112222221300000
000000000000000000000000033303331121223300000
000000000000000000000000000000033311113000000
000000000000000000000000000000000333333000000
003000000000000000000000000000000330300000000
330000000000000000000000000000000000000000000
130000000000000000000000000000000000000000000
