00000000000000000000000000000000000000000000000000
00300000000000000000000000000000000000000000000000
03300000000000000000000000000000000000000000000000
03300000000000000000000000000000000003330000000300
33330000000000000000000000000000000033303000000033
03300000000000000000000000000000003003330000000033
03300000000000000000000000000030000333303000000000
00000000000000000000000000000333033311330000000000
00000000000000000000000000030033331111130300000000
00000000000000000000000000003331111111133030000000
00000000000000000000000000333111111111330300000000
00000000000000000000000000033111111111333333000000
00000000000000000000000000303414111111130300000000
00000000000000000000000000033411111113330303000000
00000000000000000000000000033411411113033333000000
00000000000000000003000000003111114413333330000000
00000000000000000303030000333144411114113300000000
00000033000330033000033333311111111114333000000000
00000033033003333303331111141111111133300000000000
00000033333333111333111111141111113330000000000000
00000031144111411111111111141141113000000000000000
00003331111111411111111111141141113300000000000000
00000034111111111111111111111141111300000000000000
00003034111111111111111111111141111303000000000000
00000334111111111114111111111111111333000000000000
00000034111111111114111111111113333333000000000000
00000033111111411111111133333333330300000000000000
00000003111141411444111130333300000000000000000000
00000003314114111111111330000000000003300030030000
00000000311114111111111300000000003303300003033000
00000003314111111111433300000000333033000003330000
00000303114111111111430000000000033333003300030000
00000033114111111111130300000000334443333333003000
00000003114111133333333000003003031111114133033300
00000003314111130030033000033030031111114330333000
00000000311113330000000000033333331111114303330330
00000033311113000000000003031111144111113333033333
00000000344443030000000000331111111111113033330330
00000003311113300000000030031411111111113300030333
00000000314113003000000030333411111111133033330333
00000000334113330000000330031111111111333300300000
00000000034111130000000300333111333111300000000000
00000000334111133000000000003333303313300000000000
00000000311111130030000033330003330313330000000000
00000000331111133300000033003330330333330000000000
00000000031111143000000003333133333331330000000000
00000000331113333300000000333333330333300000000000
00000003031133003300000000030333303003300000000000
00000000333333000000000000000003330300000000000000
00000000033030000000000000000030033300000000000000
00000000000000000000000000000003303300000000000000
00000000000000000000000000000033033000000000000000
00000000033000000000000000000000333000000000000000
00000000033000000000000000000000033000000000000000
00000000000000000000000000000000000000000000000000
00000000000000000000000000000000000000000000000000
00000000000000000000000000000000000000000000000000
00000000000000000000000000000000000000000000000000
00000000000000000000000000000000000000000000000000
00000000000000000000000000000000000000000000000000
00000000000000000000000000000000000000000000000000
00000000000000000000000000000000000000000000000000
00000000000000000000000000000000000000000000000000
00000000000000000000000000000000000000000000000000
00000000000000000000000000000000000000000000000000
00000000000000000000000000000000000003000000000000
00000000000000000000000000000000000003300000000000
00000000000000000000000000000000000003300000000000
00000000000000000000000000000000000000000000000000
00000000000000000000000000000000000000000000000000
00000000000000000000000000000000000000000000000000
00000000000000000000000000000000000000000000000000
00000000000000000000000000000000000000000000000000
00000000000000000000000000000000000000000000000000
00000000000000000000000000000000000000000000000000
