000000000000000000000000000000000000000000000
000000000000000000000000000000000000000000000
000000000000000000000000000000000003300000000
000003003030300000000000000000000300330000000
003300333333300000000000000000030033333000000
003333311111333000000000000000003303330000000
033111111111113333000000000000003033300000000
031141111111112123300000000000033303300000000
033141111111222222300330000003331300000000000
003141111111222221333330000000031330000000000
033331114141122222111330000000331330000000000
000031111141122221114333330000031330000000000
000033311141111221111111130000033303000000000
000000311111111111411113333000000033330000000
000000311111111111411133033000000033133000000
000033311111411111111130003000000003330000000
000031114441221111113333330000000000330000000
000331114111221111143033033000000030330000000
033311141144441441143333030000000303300000000
033311111111113333113303033000000333330000000
030311111133333303113333303000030030300000000
003311111330303003114303330000003033300000000
000311111300330333414330300000033303300000000
003311111303303313333333000000003033300000000
000344411333333133000333000000000003300000000
003331111111111330330300000000000000000000000
003034111111111300330000000000000000000000000
000334111111111300333000000000000000000000000
003333111111111333333000000000000000000000000
000003114411111111133000000000000000000000000
000003331111111111113300000000000000000000000
000000333333111111133300000000000000030000000
000000333003331111130000000000000000003300000
000000000000333311130000000000000000033000000
303000000000000311133000000000000000003000000
330000000000000331130000000000000000330300000
330000000000000033330000000000000003303000000
000000000000000033000000000000003300003330000
000000000000000000000000000000000000033300000
000000000000000000000000030300000003330000000
000000000000000000000003303030000000003300000
000000000000000000000000033300000000303300000
000000000000000000000330031330000033333300000
000000000000000000000030031133000031111333000
000000000000000000003330331113303031111330000
000000000000000030303133311111330331113300000
000000000000030033333411111111133311133000000
000003003303033003111111111111122111330000000
000003330303300333111114111111122111330000000
000003333330333314111114111111222211330000000
000033333333033114141111111111122111303030000
000000000033003114141111111133333311333300000
000000000000303314141111113330300311113330000
000000000000030314111333313300033311113300000
000000000000000333113333333000331111113300000
000000000000000033123030000003031113333000000
000000000000000033323033333003334443003300000
000000000000000030333331330333031133303000000
000000033000000003003133303300033330330000000
000000330300000000033330330300000303330000000
000000333300000000033033303333000003333330000
000033311330300000033300330330000000030333000
000331122133000000000000000000000000000000000
000033332113033000000000000000000000000000000
000033033113333300000000000000000000000000000
000000303112303333000000000000000000000000000
000000003442330033000000000000000003030000000
000000033111300333000000000000000003300000000
000000031111330300000000003000003033000000000
000000031133303330000000000330333033000000000
000000033333333300000000003330330000000000000
000000000333003300000300000000000000000000000
000000000333000000000330000000000000000000000
000000000000000000003330000000000000000000000
000000000000000000003333000000000000000000000
000000000000000000000330000000000000000000000
000000000000000000000330000000000000000000000
000000000000000000000000000000000000000000000
000000000000000000000000000000000000000000000
000000000000000000000000000000000000000000000
000000000000000000000000000000000000000000000
