000000000000000000000000000000000000000000000000
000000000000000000000000000000000000000000000000
000000000000000000000000000000000000000000000000
000000000003300000000000000000000000000000000000
000000000033033000000000003303000000000000000000
000000000003330000000000003333300000000000000000
000000000033233000000000033113000000000000000000
000000000032233000000000003113330000000000000000
000000003332213000000030033111300300000000000000
000000333332213030000033303144333000000000000000
000000030331113300000003333111113300300000000000
000000000031113030333333441144144330330300000000
000000003331113333031111111111111133333000000000
000000000331111113331111111141111111433000000000
000000000031111111122114144141111114130000000000
000000330031111111122114111141111114133000000000
000000003031111111114111111141111111130300000000
000000000333331111114111111111111111133000000000
000000000000311111114111111111144444430000000000
000000000000333333114111111111111111133000000000
000000000000303003114111111144111111130000000000
000000000000000303114111111111111111130000033000
000000000000000333111111111111111114433303333000
000000000000000003111141111111111111111333113300
000000000000000003331141111111111111111111113300
000000000000000000331141111111144111111111113000
000000000000000000033341111111111111111441113300
000000000000000000000333333331111114111111113300
000000000000000000000330303033311114111111113300
000000000000000000000000000003333333311111113030
000000000000000000000000000003330300314411113300
000000000000000000000000000000000000333111113300
000000000000000000000000000000000000003333113000
000000000000000000000000000000000000003003133000
000000000000000000000000000000000000000303130300
000000000000000000000000000000000000000033133000
000000000000000000000000000000000000000331130300
000000000000000000000000000000000000330311133300
000000000000000000000000000000000000333311113300
000000000000000000000000000000000033311111111300
330300030003000000000000000000000031411111133300
033000003330000000000000000000003331411111130000
000000030000000000000000000000030031411111133300
000000000000000000000000000000033331111111133000
000000000000000000000000000000003211144111130000
000000000000000000000000000000333211111111133300
000000000000000033000000000003032222111111113000
000000000000000003300303030003332222111111113300
000000000000000033033000030333222222244111113000
000000000000303033333303333312222222211221113300
000000000000033031111333111112222222222221113000
000000000000330031111111111122222222222211113300
000000000003000331111114444222222222222221133300
000000000000303311411112121222222221121221130000
000000000003033111411112222222222221144411130000
000000000300331111411111222222222222111111133000
000000000033311111411112222222221122111111130000
000000000033111111411111222222221111111111330000
000000000003111111111111222222211111111411300000
000000000003331111444411112222111111111411330000
000000000000331111111111133332111113333333330000
000000000000333311333333330034111113033003300000
000000000000003333303333000034111133000003300000
000000000000000330000000000334141133000000000000
000000000000000000000000000333111133000000000000
000000000000000000000000000003144133300000000000
000000000000000000000000000003111133000000000000
000000000000000000000000000033111130000000000000
000000000000000000000000000003111133000000000000
000000000000000000000000000003311130000000000000
000000000000000000000000000000311133000000000000
000000000000000000000000000000331133000000000000
000000000000000000000000000003311113030000000000
000000000000303000000000000000311413033300000000
000000000003333300000000000030311113331330030000
000000003003111300000000000033344411111233300000
000000000333111333000000000031111113333113300000
000000000331411113330000003331111113003333000000
000000000031411111430000000333121233003033300000
000000003331111141433000000003222230003033000000
000000000031141141413030030003222233030300000000
000000000332141141413333300333222230333000000000
000000003032141141411111333311221130300000000000
000000003331141111411111111111221133300000000000
000000000031141111111411441111111113000000000000
000000000331141114441411111111114113000000000000
000000000032141111111111111114114113333000000000
000000000331141111111111144414114441430000000000
000003003031141111111111111333333111133300000000
000003030331141111111111133303333331111330000000
000303033311141111111111330000000031111330000000
000330303111111333333311330000000031111303000000
000333333111113300003311330000000331111330000000
003333333333333000000333330000000031111300000000
003000003333033000000330300000000033333333000000
000000000000000000000000000000000033330330000000
