000000003000000000000000000000000000000000000
000000030330000000000000000000000000000000000
000000003330000000000000000000000000000000000
000000000330000000000000000000000000000000000
000000000000000000000000000000000000000000000
000000000000000000000000000000000000000000000
000000000000000000000000000000000000000000000
000000000000000000000000000000000000000000000
000000000000000000000000000000000000000000000
000000000000000000000000000000000000000000000
000000000000000000000000000000000000000000000
000003000000000000000000000000000000000000000
330330000000000000000000000000000000000000000
300330000000000000000000000000000000000000000
330000000000000000000000000000000000000000000
000000000000000000000000000000000000000000000
000000000000000000000030000000000000000000000
000000000000000000033300000000000000000000000
000000000000000000003330000000000000000000000
000000000000000000033330000000000000000000000
000000000000000003031300000000000000000000000
000000000000000000333300000000000000000000000
000000000000000300330000000000000000000000000
000000000000003033330000000000000000000000000
000000000000003331133000000000000000000000000
000000303000003111130300000000000000000000000
000000333003033111133300000000000000000000000
000003313330031111113330300000000000003000000
000303111130031111223033333330000033033330000
000333111133331211223330333300030300030030000
003311111111112222222133330303033333330000000
003311141111112222222133033303033333000000000
003333141111122222211130333333330003000000000
000333331111112222211133300030303033000000000
000000031111122222221133000000333303000000000
000000033111112222211330333300000330000000000
000000303111122222224303003030000000000000000
000000033111111211221330300330000000000000000
000000331111111111441330330330000000000000000
000000331111111111111333333330000000000000000
000000311111111333333303003000000000000000000
003030331111113303303033330000000000000000000
003330333333113033330300003000000000000000000
033130333003133030333003333300000000000000000
303133313033130033033000333000000000000000000
033114113331333333333000300000000000000000000
003114111113303030300000000000000000000000000
033334111113330333000000000000000000000000000
000034111113003000000000000000000000000000000
003334111413333030000000000000000000000000000
033111141411443330030003000000000000000000000
003111141411111133330303303003000000000000000
333111111411111144433333030333000000000000000
331113331411141111111413333330000000000000000
031133031111141111411411114300000000000000000
333333333111144111411411114300000000000000000
033033303111111111411111114333030330000000000
333330333111411111111111114113333330000000000
031300031111411111111111114111111300000000000
331300031411111111111111114111111330000000000
031333331111141111141111111111113300000000000
331111111111141111141111111111113000000000000
111111111111141141111111111111113000000000000
331111411111111141111114111111113000000000000
031111411111111111111114141111113000000000000
331111111111111111111114141111113300000000000
031144441111111111111111111111113300000000000
333311111111113333311111111113333333000000000
300314411333333000311111111113030333000000000
000333333300030003311221111113330003300000000
000330330000000000331221111111233333000000000
003330300000000000333331111113330030300000000
000303300033030000033033311113333333000000000
003333030303300000000003333333303033000000000
000303303300330000000000003030000000000000000
000000003333033000000000000000000000000000000
000000000033033300000000000000000000000000000
000000000033333000000000000000000000000000000
000000000000300000000000000000000000000000000
000000000000000000000000000000000000000000000
000000000000000000000000000000000000000000000
