000000000000000000000033303343300300000000000000
000000000000000000030333333113003330000000000000
000000000000000000003003111113333300000000000000
000000000003033000003003111411111333000000000000
000000000300330000300003111111111113300000000000
000000000033300000030333111111144111330000000000
000000003331330003330033111441111111133000000000
000000000311330303333034441111441111133000000000
000000003313330030333333111111111444130000000000
000000003113333303300303441111111111133000000000
000000003333313300000333111414411111333000000000
000000000333333000000321411411114114300000000000
000000000000333300300321411411111114300000000000
000000000003333303033311111411111111330000000000
000000000030303303331111111413331111303000000000
000000003333030033111111133333033111330000000000
000000003330003031111113333300003113330000000000
000000000030033333311113000000003333000000000000
000000000000333330331113030000003300000000000000
000000000000033030311113300000000000000000000000
000000000000000303333133300000000000000000000000
000000000000000003333333000000000000000000000000
000000000000000000003303300000000000000000000000
000000000000000333030030300000000000000000000000
000000000000030333303303330000033330000000000000
000000000000003311333003330000033333000000000000
000000000000003333333330300000033003300000000000
000000000000000033030033000000333303000000000000
000000000000000333033300000030303333300000000000
000000000000000313333030003303033333000000000000
000000000000000312223330003333330000300000000000
000030000000003333222303033233030000000000000000
000030000000000033333330333233000000000000000000
000330330000000030003300003130300000000000000000
000003300000000330333000033333300000000000000000
000033330000000333030000000033000000000000000000
000000330000000333300000000000000000000000000000
000000000000000333000000000000000000000000000000
000000000003000000000000000000000000000000000000
000000000003330000000000000000000000000000000000
000000000003130000000000000000000000000000000000
000000000033330000330300000000000000000000000000
000000000000330330033000000000000000000000000000
000000000003303300333300000000000000000000000000
000000000000333330033000000000000000000000000000
000000000000333300000000000000000000000000000000
000000000000003300000000000000000000000000000000
000000000000000000000000000000000000000000000000
000000000000000000000000000000000000000000030300
000000000000000000000000000000000000000000003000
000000000000000000000000000000000003300000000000
000000000000000000000000000000000003333000000000
000000000000000000000000000000000033330000000000
000000000300300000000000000000000003300000000000
000000000330300000000000000000000003300000000000
000000003333330000000000000000000000000000000000
000000003313300000000000000000000000000000000000
000000003313000000000000000000000000000000000000
000000300313033000000000000000000000000000000000
000000000313330000000000000000000000000000000000
000333333311133300000000000000000000000000000000
000030031113333000000000000000000000000000000000
000033331133000300000000000000000000000000000000
000331133330000000000000000000000000000000000000
000321130333030000000000000000000000000000000000
000333333303033000000000000000000000000000000000
003303303000000300000000000000000000000000000000
000000000000003333330000000000000000000000330000
000000000000033033300000000000000000000333033000
000000000000000303330000000000000000000033333000
000000000000000033333000000000000000000031130000
000000000000000000330000000000000000000331133000
000000000000000000000000000000000000003031130000
303300000000000000000000000000000003030031130000
333000000000000000000000000000000003333331133000
033000000000000000000000000000000033111111133000
000000000000000000000000000000000003311113330000
000000000000000000000000000000003000311113300000
000003330000000000000000000000033300311113000000
000003300000000000000000000000003333311113300000
000000000000000000000000000300333111111113000000
000000000000000000000000000033311111111333300000
000000000000000000000000000031144122133303300000
000000000000000000000000003333333333330000000000
000000000000000000000000000330300300330000000000
000000000000000000000000000000000000000000000000
000000003030000000000000000000000000000000000000
000000000303000000000000000000000000000000000000
000000000333330030000000000000000000000000000000
000000003031133300000000000000000000000000000000
000000003331113300000000000000000000000000000000
000000000031113000000000000000000000000000000000
000000003331133000000000000000000000000000000000
000000000031130000000000000000000000000000000000
000000003333330000000000000000000000000000000000
000000000033000000000000000000000000000000000000
